Year,Season,Nation,Gold,Silver,Bronze,Medals
1960,Summer,Russia,43,29,31,103
1960,Summer,USA,34,21,16,71
1960,Summer,Germany,12,19,11,42
1960,Summer,Italy,13,10,13,36
1960,Summer,Australia,8,8,6,22
1960,Summer,Hungary,6,8,7,21
1960,Summer,Poland,4,6,11,21
1960,Winter,Russia,7,5,9,21
1960,Summer,UK,2,6,12,20
1960,Summer,Japan,4,7,7,18
1960,Summer,Romania,3,1,6,10
1960,Winter,USA,3,4,3,10
1960,Summer,Turkey,7,2,0,9
1960,Summer,Czech Republic,3,2,3,8
1960,Winter,Finland,2,3,3,8
1960,Winter,Germany,4,3,1,8
1960,Summer,Bulgaria,1,3,3,7
1960,Winter,Sweden,3,2,2,7
1960,Winter,Austria,1,2,3,6
1960,Summer,Denmark,2,3,1,6
1960,Winter,Norway,3,3,0,6
1960,Summer,Sweden,1,2,3,6
1960,Summer,Switzerland,0,3,3,6
1960,Summer,Finland,1,1,3,5
1960,Summer,France,0,2,3,5
1960,Summer,Belgium,0,2,2,4
1960,Winter,Canada,2,1,1,4
1960,Summer,Iran,0,1,3,4
1960,Winter,France,1,0,2,3
1960,Summer,Netherlands,0,1,2,3
1960,Summer,New Zealand,2,0,1,3
1960,Summer,South Africa,0,1,2,3
1960,Summer,Argentina,0,1,1,2
1960,Summer,Austria,1,1,0,2
1960,Summer,Brazil,0,0,2,2
1960,Winter,Netherlands,0,1,1,2
1960,Summer,Pakistan,1,0,1,2
1960,Winter,Poland,0,1,1,2
1960,Summer,Serbia,1,1,0,2
1960,Winter,Switzerland,2,0,0,2
1960,Summer,Syria,0,1,1,2
1960,Summer,Trinidad,0,0,2,2
1960,Summer,Canada,0,1,0,1
1960,Winter,Czech Republic,0,1,0,1
1960,Summer,Ethiopia,1,0,0,1
1960,Summer,Ghana,0,1,0,1
1960,Summer,Greece,1,0,0,1
1960,Summer,India,0,1,0,1
1960,Summer,Iraq,0,0,1,1
1960,Winter,Italy,0,0,1,1
1960,Summer,Mexico,0,0,1,1
1960,Summer,Morocco,0,1,0,1
1960,Summer,Norway,1,0,0,1
1960,Summer,Portugal,0,1,0,1
1960,Summer,Singapore,0,1,0,1
1960,Summer,Spain,0,0,1,1
1960,Summer,Taiwan,0,1,0,1
1960,Summer,Venezuela,0,0,1,1
1964,Summer,Russia,30,30,33,93
1964,Summer,USA,36,26,28,90
1964,Summer,Germany,10,22,18,50
1964,Summer,Japan,16,5,8,29
1964,Summer,Italy,10,10,7,27
1964,Winter,Russia,11,7,6,24
1964,Summer,Poland,7,6,10,23
1964,Summer,Hungary,10,7,5,22
1964,Summer,Australia,6,2,10,18
1964,Summer,UK,4,12,2,18
1964,Summer,France,1,8,6,15
1964,Winter,Norway,3,6,6,15
1964,Summer,Czech Republic,5,6,3,14
1964,Winter,Austria,4,5,3,12
1964,Summer,Romania,2,4,6,12
1964,Summer,Bulgaria,3,5,2,10
1964,Winter,Finland,3,4,3,10
1964,Summer,Netherlands,2,4,4,10
1964,Winter,Germany,3,3,3,9
1964,Summer,Sweden,2,2,4,8
1964,Winter,France,3,4,0,7
1964,Winter,Sweden,3,3,1,7
1964,Winter,USA,1,2,4,7
1964,Summer,Denmark,2,1,3,6
1964,Summer,Turkey,2,3,1,6
1964,Summer,Finland,3,0,2,5
1964,Summer,New Zealand,3,0,2,5
1964,Summer,Serbia,2,1,2,5
1964,Summer,Canada,1,2,1,4
1964,Winter,Italy,0,1,3,4
1964,Summer,Switzerland,1,2,1,4
1964,Summer,Belgium,2,0,1,3
1964,Winter,Canada,1,1,1,3
1964,Summer,South Korea,0,2,1,3
1964,Summer,Trinidad,0,1,2,3
1964,Summer,Iran,0,0,2,2
1964,Winter,Netherlands,1,1,0,2
1964,Summer,Tunisia,0,1,1,2
1964,Summer,Argentina,0,1,0,1
1964,Summer,Bahamas,1,0,0,1
1964,Summer,Brazil,0,0,1,1
1964,Summer,Cuba,0,1,0,1
1964,Winter,Czech Republic,0,0,1,1
1964,Summer,Ethiopia,1,0,0,1
1964,Summer,Ghana,0,0,1,1
1964,Summer,India,1,0,0,1
1964,Summer,Ireland,0,0,1,1
1964,Summer,Kenya,0,0,1,1
1964,Summer,Mexico,0,0,1,1
1964,Summer,Nigeria,0,0,1,1
1964,Winter,North Korea,0,1,0,1
1964,Summer,Pakistan,0,1,0,1
1964,Summer,Philippines,0,1,0,1
1964,Winter,UK,1,0,0,1
1964,Summer,Uruguay,0,0,1,1
1968,Summer,USA,45,28,34,107
1968,Summer,Russia,29,32,30,91
1968,Summer,Germany,14,20,17,51
1968,Summer,Hungary,10,10,12,32
1968,Summer,Japan,11,7,7,25
1968,Summer,Poland,5,2,11,18
1968,Summer,Australia,5,7,5,17
1968,Summer,Italy,3,4,9,16
1968,Summer,France,7,3,5,15
1968,Summer,Romania,4,6,5,15
1968,Winter,Norway,6,6,2,14
1968,Summer,Czech Republic,7,2,4,13
1968,Winter,Russia,5,5,3,13
1968,Summer,UK,5,5,3,13
1968,Winter,Germany,3,4,5,12
1968,Winter,Austria,3,4,4,11
1968,Summer,Bulgaria,2,4,3,9
1968,Winter,France,4,3,2,9
1968,Summer,Kenya,3,4,2,9
1968,Summer,Mexico,3,3,3,9
1968,Winter,Netherlands,3,3,3,9
1968,Summer,Denmark,1,4,3,8
1968,Summer,Serbia,3,3,2,8
1968,Winter,Sweden,3,2,3,8
1968,Summer,Netherlands,3,3,1,7
1968,Winter,Switzerland,0,2,4,6
1968,Summer,Canada,1,3,1,5
1968,Winter,Finland,1,2,2,5
1968,Summer,Iran,2,1,2,5
1968,Summer,Switzerland,0,1,4,5
1968,Winter,USA,1,3,1,5
1968,Summer,Austria,0,2,2,4
1968,Summer,Cuba,0,4,0,4
1968,Winter,Czech Republic,1,2,1,4
1968,Summer,Finland,1,2,1,4
1968,Winter,Italy,4,0,0,4
1968,Summer,Mongolia,0,1,3,4
1968,Summer,Sweden,2,1,1,4
1968,Summer,Brazil,0,1,2,3
1968,Winter,Canada,1,1,1,3
1968,Summer,New Zealand,1,0,2,3
1968,Summer,Argentina,0,0,2,2
1968,Summer,Belgium,0,1,1,2
1968,Summer,Ethiopia,1,1,0,2
1968,Summer,Norway,1,1,0,2
1968,Summer,South Korea,0,1,1,2
1968,Summer,Tunisia,1,0,1,2
1968,Summer,Turkey,2,0,0,2
1968,Summer,Uganda,0,1,1,2
1968,Summer,Cameroon,0,1,0,1
1968,Summer,Greece,0,0,1,1
1968,Summer,India,0,0,1,1
1968,Summer,Jamaica,0,1,0,1
1968,Summer,Pakistan,1,0,0,1
1968,Winter,Romania,0,0,1,1
1968,Summer,Taiwan,0,0,1,1
1968,Summer,Venezuela,1,0,0,1
1972,Summer,Germany,33,34,39,106
1972,Summer,Russia,50,27,22,99
1972,Summer,USA,33,31,30,94
1972,Summer,Hungary,6,13,16,35
1972,Summer,Japan,13,8,8,29
1972,Summer,Bulgaria,6,10,5,21
1972,Summer,Poland,7,5,9,21
1972,Winter,Germany,7,4,8,19
1972,Summer,Italy,5,3,10,18
1972,Summer,UK,4,5,9,18
1972,Summer,Australia,8,7,2,17
1972,Summer,Romania,3,6,7,16
1972,Winter,Russia,8,5,3,16
1972,Summer,Sweden,4,6,6,16
1972,Summer,France,2,4,7,13
1972,Winter,Norway,2,5,5,12
1972,Winter,Switzerland,4,3,3,10
1972,Summer,Kenya,2,3,4,9
1972,Winter,Netherlands,4,3,2,9
1972,Summer,Cuba,3,1,4,8
1972,Summer,Czech Republic,2,4,2,8
1972,Summer,Finland,3,1,4,8
1972,Winter,USA,3,2,3,8
1972,Winter,Austria,1,2,2,5
1972,Summer,Canada,0,2,3,5
1972,Winter,Finland,0,4,1,5
1972,Winter,Italy,2,2,1,5
1972,Summer,Netherlands,3,1,1,5
1972,Summer,North Korea,1,1,3,5
1972,Summer,Serbia,2,1,2,5
1972,Summer,Norway,2,1,1,4
1972,Winter,Sweden,1,1,2,4
1972,Summer,Austria,0,1,2,3
1972,Summer,Colombia,0,1,2,3
1972,Winter,Czech Republic,1,0,2,3
1972,Winter,France,0,1,2,3
1972,Summer,Iran,0,2,1,3
1972,Winter,Japan,1,1,1,3
1972,Summer,New Zealand,1,1,1,3
1972,Summer,Switzerland,0,3,0,3
1972,Summer,Belgium,0,2,0,2
1972,Summer,Brazil,0,0,2,2
1972,Summer,Ethiopia,0,0,2,2
1972,Summer,Greece,0,2,0,2
1972,Summer,Uganda,1,1,0,2
1972,Summer,Argentina,0,1,0,1
1972,Winter,Canada,0,1,0,1
1972,Summer,Denmark,1,0,0,1
1972,Summer,Ghana,0,0,1,1
1972,Summer,India,0,0,1,1
1972,Summer,Jamaica,0,0,1,1
1972,Summer,Lebanon,0,1,0,1
1972,Summer,Mexico,0,1,0,1
1972,Summer,Mongolia,0,1,0,1
1972,Summer,Niger,0,0,1,1
1972,Summer,Nigeria,0,0,1,1
1972,Summer,Pakistan,0,1,0,1
1972,Winter,Poland,1,0,0,1
1972,Summer,South Korea,0,1,0,1
1972,Winter,Spain,1,0,0,1
1972,Summer,Spain,0,0,1,1
1972,Summer,Tunisia,0,1,0,1
1972,Summer,Turkey,0,1,0,1
1976,Summer,Germany,50,37,42,129
1976,Summer,Russia,49,41,35,125
1976,Summer,USA,34,35,25,94
1976,Winter,Germany,9,10,10,29
1976,Summer,Romania,4,9,14,27
1976,Winter,Russia,13,6,8,27
1976,Summer,Poland,7,6,13,26
1976,Summer,Japan,9,6,10,25
1976,Summer,Bulgaria,6,9,7,22
1976,Summer,Hungary,4,5,13,22
1976,Summer,Cuba,6,4,3,13
1976,Summer,Italy,2,7,4,13
1976,Summer,UK,3,5,5,13
1976,Summer,Canada,0,5,6,11
1976,Winter,USA,3,3,4,10
1976,Summer,France,2,3,4,9
1976,Summer,Czech Republic,2,2,4,8
1976,Summer,Serbia,2,3,3,8
1976,Winter,Finland,2,4,1,7
1976,Winter,Norway,3,3,1,7
1976,Winter,Austria,2,2,2,6
1976,Summer,Belgium,0,3,3,6
1976,Summer,Finland,4,2,0,6
1976,Winter,Netherlands,1,2,3,6
1976,Summer,South Korea,1,1,4,6
1976,Summer,Australia,0,1,4,5
1976,Summer,Netherlands,0,2,3,5
1976,Summer,Sweden,4,1,0,5
1976,Winter,Switzerland,1,3,1,5
1976,Winter,Italy,1,2,1,4
1976,Summer,New Zealand,2,1,1,4
1976,Summer,Switzerland,1,1,2,4
1976,Winter,Canada,1,1,1,3
1976,Summer,Denmark,1,0,2,3
1976,Summer,Brazil,0,0,2,2
1976,Summer,Iran,0,1,1,2
1976,Summer,Jamaica,1,1,0,2
1976,Winter,Liechtenstein,0,0,2,2
1976,Summer,Mexico,1,0,1,2
1976,Summer,North Korea,1,1,0,2
1976,Summer,Norway,1,1,0,2
1976,Summer,Portugal,0,2,0,2
1976,Summer,Spain,0,2,0,2
1976,Winter,Sweden,0,0,2,2
1976,Summer,Austria,0,0,1,1
1976,Summer,Bermuda,0,0,1,1
1976,Winter,Czech Republic,0,1,0,1
1976,Winter,France,0,0,1,1
1976,Summer,Mongolia,0,1,0,1
1976,Summer,Pakistan,0,0,1,1
1976,Summer,Puerto Rico,0,0,1,1
1976,Summer,Thailand,0,0,1,1
1976,Summer,Trinidad,1,0,0,1
1976,Winter,UK,1,0,0,1
1976,Summer,Venezuela,0,1,0,1
1980,Summer,Russia,80,69,46,195
1980,Summer,Germany,47,37,42,126
1980,Summer,Bulgaria,8,16,17,41
1980,Summer,Hungary,7,10,15,32
1980,Summer,Poland,3,14,15,32
1980,Winter,Germany,9,9,10,28
1980,Summer,Romania,6,6,13,25
1980,Winter,Russia,10,6,6,22
1980,Summer,UK,5,7,9,21
1980,Summer,Cuba,8,7,5,20
1980,Summer,Italy,8,3,4,15
1980,Summer,Czech Republic,2,3,9,14
1980,Summer,France,6,5,3,14
1980,Summer,Sweden,3,3,6,12
1980,Winter,USA,6,4,2,12
1980,Winter,Norway,1,3,6,10
1980,Summer,Australia,2,2,5,9
1980,Winter,Finland,1,5,3,9
1980,Summer,Serbia,2,3,4,9
1980,Summer,Finland,3,1,4,8
1980,Winter,Austria,3,2,2,7
1980,Summer,Spain,1,3,2,6
1980,Summer,Denmark,2,1,2,5
1980,Summer,North Korea,0,3,2,5
1980,Winter,Switzerland,1,1,3,5
1980,Summer,Austria,1,2,1,4
1980,Summer,Brazil,2,0,2,4
1980,Summer,Ethiopia,2,0,2,4
1980,Winter,Liechtenstein,2,2,0,4
1980,Summer,Mexico,0,1,3,4
1980,Summer,Mongolia,0,2,2,4
1980,Winter,Netherlands,1,2,1,4
1980,Winter,Sweden,3,0,1,4
1980,Summer,Greece,1,0,2,3
1980,Summer,Jamaica,0,0,3,3
1980,Summer,Netherlands,0,1,2,3
1980,Winter,Canada,0,1,1,2
1980,Summer,Ireland,0,1,1,2
1980,Winter,Italy,0,2,0,2
1980,Summer,Switzerland,2,0,0,2
1980,Summer,Tanzania,0,2,0,2
1980,Summer,Belgium,1,0,0,1
1980,Winter,Bulgaria,0,0,1,1
1980,Winter,Czech Republic,0,0,1,1
1980,Winter,France,0,0,1,1
1980,Summer,Guyana,0,0,1,1
1980,Winter,Hungary,0,1,0,1
1980,Summer,India,1,0,0,1
1980,Winter,Japan,0,1,0,1
1980,Summer,Lebanon,0,0,1,1
1980,Winter,UK,1,0,0,1
1980,Summer,Uganda,0,1,0,1
1980,Summer,Venezuela,0,1,0,1
1980,Summer,Zimbabwe,1,0,0,1
1984,Summer,USA,82,61,30,173
1984,Summer,Germany,17,19,23,59
1984,Summer,Romania,19,16,17,52
1984,Summer,Canada,10,18,16,44
1984,Summer,UK,5,11,21,37
1984,Summer,China,15,8,9,32
1984,Summer,Italy,14,6,12,32
1984,Summer,Japan,10,7,14,31
1984,Summer,France,5,7,16,28
1984,Winter,Germany,11,10,7,28
1984,Winter,Russia,6,10,9,25
1984,Summer,Australia,4,8,12,24
1984,Summer,South Korea,6,6,7,19
1984,Summer,Sweden,2,11,6,19
1984,Summer,Serbia,7,4,7,18
1984,Winter,Finland,4,3,6,13
1984,Summer,Netherlands,5,2,6,13
1984,Summer,Finland,4,2,6,12
1984,Summer,New Zealand,8,1,2,11
1984,Winter,Norway,3,2,4,9
1984,Summer,Brazil,1,5,2,8
1984,Winter,Sweden,4,2,2,8
1984,Summer,Switzerland,0,4,4,8
1984,Winter,USA,4,4,0,8
1984,Winter,Czech Republic,0,2,4,6
1984,Summer,Denmark,0,3,3,6
1984,Summer,Mexico,2,3,1,6
1984,Summer,Spain,1,2,2,5
1984,Winter,Switzerland,2,2,1,5
1984,Summer,Belgium,1,1,2,4
1984,Winter,Canada,2,1,1,4
1984,Summer,Austria,1,1,1,3
1984,Winter,France,0,1,2,3
1984,Summer,Jamaica,0,1,2,3
1984,Summer,Kenya,1,0,2,3
1984,Summer,Norway,0,1,2,3
1984,Summer,Portugal,1,0,2,3
1984,Summer,Turkey,0,0,3,3
1984,Summer,Venezuela,0,0,3,3
1984,Summer,Algeria,0,0,2,2
1984,Summer,Greece,0,1,1,2
1984,Winter,Italy,2,0,0,2
1984,Winter,Liechtenstein,0,0,2,2
1984,Summer,Morocco,2,0,0,2
1984,Summer,Nigeria,0,1,1,2
1984,Summer,Puerto Rico,0,1,1,2
1984,Winter,Austria,0,0,1,1
1984,Summer,Cameroon,0,0,1,1
1984,Summer,Colombia,0,1,0,1
1984,Summer,Dominican Republic,0,0,1,1
1984,Summer,Egypt,0,1,0,1
1984,Summer,Iceland,0,0,1,1
1984,Summer,Ireland,0,1,0,1
1984,Summer,Ivory Coast,0,1,0,1
1984,Winter,Japan,0,1,0,1
1984,Summer,Pakistan,1,0,0,1
1984,Summer,Peru,0,1,0,1
1984,Winter,Serbia,0,1,0,1
1984,Summer,Syria,0,1,0,1
1984,Summer,Taiwan,0,0,1,1
1984,Summer,Thailand,0,1,0,1
1984,Winter,UK,1,0,0,1
1984,Summer,Zambia,0,0,1,1
1988,Summer,Germany,48,49,45,142
1988,Summer,Russia,54,31,46,131
1988,Summer,USA,36,31,27,94
1988,Summer,Bulgaria,10,12,13,35
1988,Winter,Germany,11,14,8,33
1988,Summer,South Korea,12,10,11,33
1988,Winter,Russia,11,9,9,29
1988,Summer,China,5,11,12,28
1988,Summer,Romania,7,11,6,24
1988,Summer,UK,5,10,9,24
1988,Summer,Hungary,11,6,6,23
1988,Summer,France,6,4,6,16
1988,Summer,Poland,2,5,9,16
1988,Winter,Switzerland,5,5,5,15
1988,Summer,Australia,3,6,5,14
1988,Summer,Italy,6,4,4,14
1988,Summer,Japan,4,3,7,14
1988,Summer,New Zealand,3,2,8,13
1988,Summer,Serbia,3,4,5,12
1988,Summer,Sweden,0,4,7,11
1988,Winter,Austria,3,5,2,10
1988,Summer,Canada,3,2,5,10
1988,Summer,Kenya,5,2,2,9
1988,Summer,Netherlands,2,2,5,9
1988,Summer,Czech Republic,3,3,2,8
1988,Winter,Finland,4,1,2,7
1988,Winter,Netherlands,3,2,2,7
1988,Summer,Brazil,1,2,3,6
1988,Winter,Sweden,4,0,2,6
1988,Winter,USA,2,1,3,6
1988,Winter,Canada,0,2,3,5
1988,Winter,Italy,2,1,2,5
1988,Summer,Norway,2,3,0,5
1988,Winter,Norway,0,3,2,5
1988,Summer,Denmark,2,1,1,4
1988,Summer,Finland,1,1,2,4
1988,Summer,Spain,1,1,2,4
1988,Summer,Switzerland,0,2,2,4
1988,Winter,Czech Republic,0,1,2,3
1988,Summer,Morocco,1,0,2,3
1988,Winter,Serbia,0,2,1,3
1988,Summer,Argentina,0,1,1,2
1988,Summer,Belgium,0,0,2,2
1988,Winter,France,1,0,1,2
1988,Summer,Jamaica,0,2,0,2
1988,Summer,Mexico,0,0,2,2
1988,Summer,Turkey,1,1,0,2
1988,Summer,Austria,1,0,0,1
1988,Summer,Chile,0,1,0,1
1988,Summer,Colombia,0,0,1,1
1988,Summer,Costa Rica,0,1,0,1
1988,Summer,Curacao,0,1,0,1
1988,Summer,Djibouti,0,0,1,1
1988,Summer,Greece,0,0,1,1
1988,Summer,Indonesia,0,1,0,1
1988,Summer,Iran,0,1,0,1
1988,Winter,Japan,0,0,1,1
1988,Winter,Liechtenstein,0,0,1,1
1988,Summer,Mongolia,0,0,1,1
1988,Summer,Pakistan,0,0,1,1
1988,Summer,Peru,0,1,0,1
1988,Summer,Philippines,0,0,1,1
1988,Summer,Portugal,1,0,0,1
1988,Summer,Senegal,0,1,0,1
1988,Summer,Suriname,1,0,0,1
1988,Summer,Thailand,0,0,1,1
1988,Summer,"Virgin Islands, US",0,1,0,1
1992,Summer,Russia,45,38,29,112
1992,Summer,USA,37,34,37,108
1992,Summer,Germany,33,21,28,82
1992,Summer,China,16,22,15,53
1992,Summer,Cuba,14,6,11,31
1992,Summer,Hungary,11,12,7,30
1992,Summer,France,8,5,16,29
1992,Summer,South Korea,12,5,11,28
1992,Summer,Australia,7,9,11,27
1992,Winter,Germany,10,10,6,26
1992,Winter,Russia,9,6,8,23
1992,Summer,Japan,3,8,11,22
1992,Summer,Spain,13,7,2,22
1992,Winter,Austria,6,7,8,21
1992,Summer,UK,5,3,12,20
1992,Summer,Italy,6,5,8,19
1992,Summer,Poland,3,6,10,19
1992,Summer,Canada,7,4,7,18
1992,Summer,Romania,4,6,8,18
1992,Winter,Norway,7,5,5,17
1992,Summer,Bulgaria,3,7,6,16
1992,Summer,Netherlands,2,6,7,15
1992,Winter,Italy,4,6,4,14
1992,Summer,Sweden,1,7,4,12
1992,Winter,USA,5,4,2,11
1992,Summer,New Zealand,1,4,5,10
1992,Winter,France,3,5,1,9
1992,Summer,North Korea,4,0,5,9
1992,Summer,Kenya,2,4,2,8
1992,Winter,Canada,2,3,2,7
1992,Summer,Czech Republic,4,2,1,7
1992,Winter,Finland,3,1,3,7
1992,Winter,Japan,1,2,4,7
1992,Summer,Norway,2,4,1,7
1992,Summer,Denmark,1,1,4,6
1992,Summer,Turkey,2,2,2,6
1992,Summer,Finland,1,2,2,5
1992,Summer,Indonesia,2,2,1,5
1992,Summer,Jamaica,0,3,1,4
1992,Winter,Netherlands,1,1,2,4
1992,Summer,Nigeria,0,3,1,4
1992,Winter,South Korea,2,1,1,4
1992,Winter,Sweden,1,0,3,4
1992,Summer,Belgium,0,1,2,3
1992,Summer,Brazil,2,1,0,3
1992,Winter,China,0,3,0,3
1992,Summer,Croatia,0,1,2,3
1992,Winter,Czech Republic,0,0,3,3
1992,Summer,Ethiopia,1,0,2,3
1992,Summer,Individual Olympic Athletes,0,1,2,3
1992,Summer,Iran,0,1,2,3
1992,Summer,Latvia,0,2,1,3
1992,Summer,Morocco,1,1,1,3
1992,Winter,Switzerland,1,0,2,3
1992,Summer,Algeria,1,0,1,2
1992,Summer,Austria,0,2,0,2
1992,Summer,Estonia,1,0,1,2
1992,Summer,Greece,2,0,0,2
1992,Summer,Ireland,1,1,0,2
1992,Summer,Israel,0,1,1,2
1992,Summer,Lithuania,1,0,1,2
1992,Winter,Luxembourg,0,2,0,2
1992,Summer,Mongolia,0,0,2,2
1992,Summer,Namibia,0,2,0,2
1992,Summer,Slovenia,0,0,2,2
1992,Summer,South Africa,0,2,0,2
1992,Summer,Argentina,0,0,1,1
1992,Summer,Bahamas,0,0,1,1
1992,Summer,Colombia,0,0,1,1
1992,Summer,Ghana,0,0,1,1
1992,Summer,Malaysia,0,0,1,1
1992,Summer,Mexico,0,1,0,1
1992,Winter,New Zealand,0,1,0,1
1992,Winter,North Korea,0,0,1,1
1992,Summer,Pakistan,0,0,1,1
1992,Summer,Peru,0,1,0,1
1992,Summer,Philippines,0,0,1,1
1992,Summer,Puerto Rico,0,0,1,1
1992,Summer,Qatar,0,0,1,1
1992,Winter,Spain,0,0,1,1
1992,Summer,Suriname,0,0,1,1
1992,Summer,Switzerland,1,0,0,1
1992,Summer,Taiwan,0,1,0,1
1992,Summer,Thailand,0,0,1,1
1994,Winter,Germany,9,7,8,24
1994,Winter,Norway,8,10,5,23
1994,Winter,Russia,11,8,4,23
1994,Winter,Italy,7,5,8,20
1994,Winter,Canada,3,6,4,13
1994,Winter,USA,6,5,2,13
1994,Winter,Austria,2,3,4,9
1994,Winter,Switzerland,3,4,2,9
1994,Winter,Finland,0,1,5,6
1994,Winter,South Korea,4,1,1,6
1994,Winter,France,0,1,4,5
1994,Winter,Japan,1,2,2,5
1994,Winter,Netherlands,0,1,3,4
1994,Winter,China,0,1,2,3
1994,Winter,Kazakhstan,1,2,0,3
1994,Winter,Slovenia,0,0,3,3
1994,Winter,Sweden,2,1,0,3
1994,Winter,Belarus,0,2,0,2
1994,Winter,UK,0,0,2,2
1994,Winter,Ukraine,1,0,1,2
1994,Winter,Australia,0,0,1,1
1994,Winter,Uzbekistan,1,0,0,1
1996,Summer,USA,44,32,25,101
1996,Summer,Germany,20,18,27,65
1996,Summer,Russia,26,21,16,63
1996,Summer,China,17,22,12,51
1996,Summer,Australia,9,9,23,41
1996,Summer,France,15,7,15,37
1996,Summer,Italy,13,10,12,35
1996,Summer,South Korea,7,15,5,27
1996,Summer,Cuba,9,8,8,25
1996,Summer,Ukraine,9,2,12,23
1996,Summer,Canada,3,11,8,22
1996,Summer,Hungary,7,4,10,21
1996,Summer,Netherlands,4,5,10,19
1996,Summer,Romania,4,7,8,19
1996,Summer,Poland,7,5,5,17
1996,Summer,Spain,5,6,6,17
1996,Summer,Belarus,1,6,8,15
1996,Summer,Brazil,3,3,9,15
1996,Summer,Bulgaria,3,7,5,15
1996,Summer,UK,1,8,6,15
1996,Summer,Japan,3,6,5,14
1996,Summer,Czech Republic,4,3,4,11
1996,Summer,Kazakhstan,3,4,4,11
1996,Summer,Greece,4,4,0,8
1996,Summer,Kenya,1,4,3,8
1996,Summer,Sweden,2,4,2,8
1996,Summer,Norway,2,2,3,7
1996,Summer,Switzerland,4,3,0,7
1996,Summer,Belgium,2,2,2,6
1996,Summer,Denmark,4,1,1,6
1996,Summer,Jamaica,1,3,2,6
1996,Summer,New Zealand,3,2,1,6
1996,Summer,Nigeria,2,1,3,6
1996,Summer,Turkey,4,1,1,6
1996,Summer,North Korea,2,1,2,5
1996,Summer,South Africa,3,1,1,5
1996,Summer,Finland,1,2,1,4
1996,Summer,Indonesia,1,1,2,4
1996,Summer,Ireland,3,0,1,4
1996,Summer,Serbia,1,1,2,4
1996,Summer,Algeria,2,0,1,3
1996,Summer,Argentina,0,2,1,3
1996,Summer,Austria,0,1,2,3
1996,Summer,Ethiopia,2,0,1,3
1996,Summer,Iran,1,1,1,3
1996,Summer,Slovakia,1,1,1,3
1996,Summer,Armenia,1,1,0,2
1996,Summer,Croatia,1,1,0,2
1996,Summer,Georgia,0,0,2,2
1996,Summer,Malaysia,0,1,1,2
1996,Summer,Moldova,0,1,1,2
1996,Summer,Morocco,0,0,2,2
1996,Summer,Namibia,0,2,0,2
1996,Summer,Portugal,1,0,1,2
1996,Summer,Slovenia,0,2,0,2
1996,Summer,Thailand,1,0,1,2
1996,Summer,Trinidad,0,0,2,2
1996,Summer,Uzbekistan,0,1,1,2
1996,Summer,Azerbaijan,0,1,0,1
1996,Summer,Bahamas,0,1,0,1
1996,Summer,Burundi,1,0,0,1
1996,Summer,Costa Rica,1,0,0,1
1996,Summer,Ecuador,1,0,0,1
1996,Summer,India,0,0,1,1
1996,Summer,Israel,0,0,1,1
1996,Summer,Latvia,0,1,0,1
1996,Summer,Lithuania,0,0,1,1
1996,Summer,Mexico,0,0,1,1
1996,Summer,Mongolia,0,0,1,1
1996,Summer,Mozambique,0,0,1,1
1996,Summer,Philippines,0,1,0,1
1996,Summer,Puerto Rico,0,0,1,1
1996,Summer,Syria,1,0,0,1
1996,Summer,Taiwan,0,1,0,1
1996,Summer,Tonga,0,1,0,1
1996,Summer,Tunisia,0,0,1,1
1996,Summer,Uganda,0,0,1,1
1996,Summer,Zambia,0,1,0,1
1998,Winter,Germany,12,9,8,29
1998,Winter,Norway,8,9,5,22
1998,Winter,Russia,9,6,3,18
1998,Winter,Austria,3,5,9,17
1998,Winter,Canada,6,5,4,15
1998,Winter,USA,6,3,4,13
1998,Winter,Finland,2,4,6,12
1998,Winter,Netherlands,5,4,2,11
1998,Winter,Italy,2,6,2,10
1998,Winter,Japan,5,1,4,10
1998,Winter,China,0,6,2,8
1998,Winter,France,2,1,5,8
1998,Winter,Switzerland,2,2,3,7
1998,Winter,South Korea,3,1,2,6
1998,Winter,Czech Republic,1,1,1,3
1998,Winter,Sweden,0,2,1,3
1998,Winter,Belarus,0,0,2,2
1998,Winter,Kazakhstan,0,0,2,2
1998,Winter,Australia,0,0,1,1
1998,Winter,Belgium,0,0,1,1
1998,Winter,Bulgaria,1,0,0,1
1998,Winter,Denmark,0,1,0,1
1998,Winter,UK,0,0,1,1
1998,Winter,Ukraine,0,1,0,1
2000,Summer,USA,36,24,31,91
2000,Summer,Russia,32,28,29,89
2000,Summer,Australia,16,25,17,58
2000,Summer,China,28,16,14,58
2000,Summer,Germany,13,17,26,56
2000,Summer,France,13,14,11,38
2000,Summer,Italy,13,8,13,34
2000,Summer,Cuba,11,11,7,29
2000,Summer,South Korea,8,10,10,28
2000,Summer,UK,11,10,7,28
2000,Summer,Romania,11,6,9,26
2000,Summer,Netherlands,12,9,4,25
2000,Summer,Ukraine,3,10,10,23
2000,Summer,Japan,5,8,5,18
2000,Summer,Belarus,3,3,11,17
2000,Summer,Hungary,8,6,3,17
2000,Summer,Canada,3,3,8,14
2000,Summer,Poland,6,5,3,14
2000,Summer,Bulgaria,5,6,2,13
2000,Summer,Greece,4,6,3,13
2000,Summer,Brazil,0,6,6,12
2000,Summer,Sweden,4,5,3,12
2000,Summer,Spain,3,3,5,11
2000,Summer,Norway,4,3,3,10
2000,Summer,Jamaica,0,6,3,9
2000,Summer,Switzerland,1,6,2,9
2000,Summer,Czech Republic,2,3,3,8
2000,Summer,Ethiopia,4,1,3,8
2000,Summer,Kazakhstan,3,4,0,7
2000,Summer,Kenya,2,3,2,7
2000,Summer,Denmark,2,3,1,6
2000,Summer,Georgia,0,0,6,6
2000,Summer,Indonesia,1,3,2,6
2000,Summer,Mexico,1,2,3,6
2000,Summer,Algeria,1,1,3,5
2000,Summer,Belgium,0,2,3,5
2000,Summer,Lithuania,2,0,3,5
2000,Summer,Morocco,0,1,4,5
2000,Summer,Slovakia,1,3,1,5
2000,Summer,South Africa,0,2,3,5
2000,Summer,Taiwan,0,1,4,5
2000,Summer,Turkey,3,0,2,5
2000,Summer,Argentina,0,2,2,4
2000,Summer,Finland,2,1,1,4
2000,Summer,Iran,3,0,1,4
2000,Summer,New Zealand,1,0,3,4
2000,Summer,North Korea,0,1,3,4
2000,Summer,Uzbekistan,1,1,2,4
2000,Summer,Austria,2,1,0,3
2000,Summer,Azerbaijan,2,0,1,3
2000,Summer,Bahamas,2,0,1,3
2000,Summer,Estonia,1,0,2,3
2000,Summer,Latvia,1,1,1,3
2000,Summer,Nigeria,1,2,0,3
2000,Summer,Serbia,1,1,1,3
2000,Summer,Thailand,1,0,2,3
2000,Summer,Costa Rica,0,0,2,2
2000,Summer,Croatia,1,0,1,2
2000,Summer,Moldova,0,1,1,2
2000,Summer,Portugal,0,0,2,2
2000,Summer,Saudi Arabia,0,1,1,2
2000,Summer,Slovenia,2,0,0,2
2000,Summer,Trinidad,0,1,1,2
2000,Summer,Armenia,0,0,1,1
2000,Summer,Barbados,0,0,1,1
2000,Summer,Cameroon,1,0,0,1
2000,Summer,Chile,0,0,1,1
2000,Summer,Colombia,1,0,0,1
2000,Summer,Iceland,0,0,1,1
2000,Summer,India,0,0,1,1
2000,Summer,Ireland,0,1,0,1
2000,Summer,Israel,0,0,1,1
2000,Summer,Kuwait,0,0,1,1
2000,Summer,Kyrgyzstan,0,0,1,1
2000,Summer,Macedonia,0,0,1,1
2000,Summer,Mozambique,1,0,0,1
2000,Summer,Qatar,0,0,1,1
2000,Summer,Sri Lanka,0,1,0,1
2000,Summer,Uruguay,0,1,0,1
2000,Summer,Vietnam,0,1,0,1
2002,Winter,Germany,12,16,8,36
2002,Winter,USA,10,13,11,34
2002,Winter,Norway,12,5,7,24
2002,Winter,Austria,3,4,10,17
2002,Winter,Canada,7,3,7,17
2002,Winter,Italy,4,4,5,13
2002,Winter,Russia,5,4,4,13
2002,Winter,France,4,5,2,11
2002,Winter,Switzerland,3,2,6,11
2002,Winter,China,2,2,4,8
2002,Winter,Netherlands,3,5,0,8
2002,Winter,Finland,4,2,1,7
2002,Winter,Sweden,0,2,5,7
2002,Winter,Croatia,3,1,0,4
2002,Winter,South Korea,2,2,0,4
2002,Winter,Bulgaria,0,1,2,3
2002,Winter,Czech Republic,1,2,0,3
2002,Winter,Estonia,1,1,1,3
2002,Winter,Australia,2,0,0,2
2002,Winter,Japan,0,1,1,2
2002,Winter,Poland,0,1,1,2
2002,Winter,UK,1,0,1,2
2002,Winter,Belarus,0,0,1,1
2002,Winter,Slovenia,0,0,1,1
2004,Summer,USA,36,39,26,101
2004,Summer,Russia,28,26,36,90
2004,Summer,China,32,18,14,64
2004,Summer,Australia,17,16,17,50
2004,Summer,Germany,13,16,20,49
2004,Summer,Japan,16,9,12,37
2004,Summer,France,11,9,13,33
2004,Summer,Italy,10,11,11,32
2004,Summer,South Korea,9,12,9,30
2004,Summer,UK,9,9,12,30
2004,Summer,Cuba,9,7,11,27
2004,Summer,Netherlands,4,9,9,22
2004,Summer,Ukraine,8,5,9,22
2004,Summer,Spain,3,11,6,20
2004,Summer,Romania,8,5,6,19
2004,Summer,Hungary,8,6,3,17
2004,Summer,Greece,6,6,4,16
2004,Summer,Belarus,2,5,6,13
2004,Summer,Bulgaria,2,1,9,12
2004,Summer,Canada,3,6,3,12
2004,Summer,Turkey,3,3,5,11
2004,Summer,Brazil,5,2,3,10
2004,Summer,Poland,3,2,5,10
2004,Summer,Czech Republic,1,3,5,9
2004,Summer,Denmark,2,1,5,8
2004,Summer,Kazakhstan,1,4,3,8
2004,Summer,Thailand,3,1,4,8
2004,Summer,Austria,2,4,1,7
2004,Summer,Ethiopia,2,3,2,7
2004,Summer,Kenya,1,4,2,7
2004,Summer,Sweden,4,2,1,7
2004,Summer,Argentina,2,0,4,6
2004,Summer,Iran,2,2,2,6
2004,Summer,Norway,5,0,1,6
2004,Summer,Slovakia,2,2,2,6
2004,Summer,South Africa,1,3,2,6
2004,Summer,Azerbaijan,1,0,4,5
2004,Summer,Croatia,1,2,2,5
2004,Summer,Egypt,1,1,3,5
2004,Summer,Jamaica,2,1,2,5
2004,Summer,New Zealand,3,2,0,5
2004,Summer,North Korea,0,4,1,5
2004,Summer,Switzerland,1,1,3,5
2004,Summer,Taiwan,2,2,1,5
2004,Summer,Uzbekistan,2,1,2,5
2004,Summer,Georgia,2,2,0,4
2004,Summer,Indonesia,1,1,2,4
2004,Summer,Latvia,0,4,0,4
2004,Summer,Mexico,0,3,1,4
2004,Summer,Slovenia,0,1,3,4
2004,Summer,Belgium,1,0,2,3
2004,Summer,Chile,2,0,1,3
2004,Summer,Estonia,0,1,2,3
2004,Summer,Lithuania,1,2,0,3
2004,Summer,Morocco,2,1,0,3
2004,Summer,Portugal,0,2,1,3
2004,Summer,Zimbabwe,1,1,1,3
2004,Summer,Bahamas,1,0,1,2
2004,Summer,Colombia,0,0,2,2
2004,Summer,Finland,0,2,0,2
2004,Summer,Israel,1,0,1,2
2004,Summer,Nigeria,0,0,2,2
2004,Summer,Serbia,0,2,0,2
2004,Summer,Venezuela,0,0,2,2
2004,Summer,Cameroon,1,0,0,1
2004,Summer,Dominican Republic,1,0,0,1
2004,Summer,Eritrea,0,0,1,1
2004,Summer,India,0,1,0,1
2004,Summer,Mongolia,0,0,1,1
2004,Summer,Paraguay,0,1,0,1
2004,Summer,Syria,0,0,1,1
2004,Summer,Trinidad,0,0,1,1
2004,Summer,United Arab Emirates,1,0,0,1
2006,Winter,Germany,11,12,6,29
2006,Winter,USA,9,9,7,25
2006,Winter,Canada,7,10,7,24
2006,Winter,Austria,9,7,7,23
2006,Winter,Russia,8,6,8,22
2006,Winter,Norway,2,8,9,19
2006,Winter,Sweden,7,2,5,14
2006,Winter,Switzerland,5,4,5,14
2006,Winter,China,2,4,5,11
2006,Winter,Italy,5,0,6,11
2006,Winter,South Korea,6,3,2,11
2006,Winter,Finland,0,6,3,9
2006,Winter,France,3,2,4,9
2006,Winter,Netherlands,3,2,4,9
2006,Winter,Czech Republic,1,2,1,4
2006,Winter,Croatia,1,2,0,3
2006,Winter,Estonia,3,0,0,3
2006,Winter,Australia,1,0,1,2
2006,Winter,Poland,0,1,1,2
2006,Winter,Ukraine,0,0,2,2
2006,Winter,Belarus,0,1,0,1
2006,Winter,Bulgaria,0,1,0,1
2006,Winter,Japan,1,0,0,1
2006,Winter,Latvia,0,0,1,1
2006,Winter,Slovakia,0,1,0,1
2006,Winter,UK,0,1,0,1
2008,Summer,USA,36,39,35,110
2008,Summer,China,51,21,28,100
2008,Summer,Russia,23,21,28,72
2008,Summer,UK,19,13,16,48
2008,Summer,Australia,14,15,17,46
2008,Summer,France,7,16,18,41
2008,Summer,Germany,16,10,15,41
2008,Summer,South Korea,13,10,8,31
2008,Summer,Italy,8,9,10,27
2008,Summer,Ukraine,7,5,15,27
2008,Summer,Japan,9,7,9,25
2008,Summer,Cuba,2,11,11,24
2008,Summer,Canada,3,9,7,19
2008,Summer,Belarus,4,5,9,18
2008,Summer,Spain,5,10,3,18
2008,Summer,Brazil,3,4,9,16
2008,Summer,Netherlands,7,5,4,16
2008,Summer,Kenya,6,4,5,15
2008,Summer,Kazakhstan,2,4,7,13
2008,Summer,Hungary,3,5,2,10
2008,Summer,Poland,3,6,1,10
2008,Summer,Jamaica,5,2,2,9
2008,Summer,New Zealand,3,2,4,9
2008,Summer,Norway,3,5,1,9
2008,Summer,Romania,4,1,3,8
2008,Summer,Azerbaijan,1,2,4,7
2008,Summer,Denmark,2,2,3,7
2008,Summer,Ethiopia,4,1,2,7
2008,Summer,Switzerland,2,1,4,7
2008,Summer,Turkey,1,3,3,7
2008,Summer,Argentina,2,0,4,6
2008,Summer,Armenia,0,0,6,6
2008,Summer,Czech Republic,3,3,0,6
2008,Summer,Georgia,3,0,3,6
2008,Summer,North Korea,2,1,3,6
2008,Summer,Slovakia,3,2,1,6
2008,Summer,Uzbekistan,1,2,3,6
2008,Summer,Bulgaria,1,1,3,5
2008,Summer,Croatia,0,2,3,5
2008,Summer,Indonesia,1,1,3,5
2008,Summer,Lithuania,0,2,3,5
2008,Summer,Slovenia,1,2,2,5
2008,Summer,Sweden,0,4,1,5
2008,Summer,Finland,1,1,2,4
2008,Summer,Greece,0,2,2,4
2008,Summer,Mongolia,2,2,0,4
2008,Summer,Nigeria,0,1,3,4
2008,Summer,Taiwan,0,0,4,4
2008,Summer,Thailand,2,2,0,4
2008,Summer,Zimbabwe,1,3,0,4
2008,Summer,Austria,0,1,2,3
2008,Summer,India,1,0,2,3
2008,Summer,Ireland,0,1,2,3
2008,Summer,Latvia,1,1,1,3
2008,Summer,Mexico,2,0,1,3
2008,Summer,Serbia,0,1,2,3
2008,Summer,Algeria,0,1,1,2
2008,Summer,Bahamas,0,1,1,2
2008,Summer,Belgium,1,1,0,2
2008,Summer,Colombia,0,1,1,2
2008,Summer,Dominican Republic,1,1,0,2
2008,Summer,Estonia,1,1,0,2
2008,Summer,Iran,1,0,1,2
2008,Summer,Kyrgyzstan,0,1,1,2
2008,Summer,Morocco,0,1,1,2
2008,Summer,Portugal,1,1,0,2
2008,Summer,Tajikistan,0,1,1,2
2008,Summer,Trinidad,1,1,0,2
2008,Summer,Afghanistan,0,0,1,1
2008,Summer,Cameroon,1,0,0,1
2008,Summer,Chile,0,1,0,1
2008,Summer,Ecuador,0,1,0,1
2008,Summer,Egypt,0,0,1,1
2008,Summer,Iceland,0,1,0,1
2008,Summer,Israel,0,0,1,1
2008,Summer,Malaysia,0,1,0,1
2008,Summer,Mauritius,0,0,1,1
2008,Summer,Moldova,0,0,1,1
2008,Summer,Panama,1,0,0,1
2008,Summer,Singapore,0,1,0,1
2008,Summer,South Africa,0,1,0,1
2008,Summer,Sudan,0,1,0,1
2008,Summer,Togo,0,0,1,1
2008,Summer,Tunisia,1,0,0,1
2008,Summer,Venezuela,0,0,1,1
2008,Summer,Vietnam,0,1,0,1
2010,Winter,USA,9,15,13,37
2010,Winter,Germany,10,13,7,30
2010,Winter,Canada,14,7,5,26
2010,Winter,Norway,9,8,6,23
2010,Winter,Austria,4,6,6,16
2010,Winter,Russia,3,5,7,15
2010,Winter,South Korea,6,6,2,14
2010,Winter,China,5,2,4,11
2010,Winter,France,2,3,6,11
2010,Winter,Sweden,5,2,4,11
2010,Winter,Switzerland,6,0,3,9
2010,Winter,Netherlands,4,1,3,8
2010,Winter,Czech Republic,2,0,4,6
2010,Winter,Poland,1,3,2,6
2010,Winter,Finland,0,1,4,5
2010,Winter,Italy,1,1,3,5
2010,Winter,Japan,0,3,2,5
2010,Winter,Australia,2,1,0,3
2010,Winter,Belarus,1,1,1,3
2010,Winter,Croatia,0,2,1,3
2010,Winter,Slovakia,1,1,1,3
2010,Winter,Slovenia,0,2,1,3
2010,Winter,Latvia,0,2,0,2
2010,Winter,Estonia,0,1,0,1
2010,Winter,Kazakhstan,0,1,0,1
2010,Winter,UK,1,0,0,1
2012,Summer,USA,46,28,29,103
2012,Summer,China,38,27,24,89
2012,Summer,Russia,24,26,32,82
2012,Summer,UK,29,17,19,65
2012,Summer,Germany,11,19,14,44
2012,Summer,Japan,7,14,17,38
2012,Summer,Australia,7,16,12,35
2012,Summer,France,11,11,13,35
2012,Summer,Italy,8,9,11,28
2012,Summer,South Korea,13,8,7,28
2012,Summer,Netherlands,6,6,8,20
2012,Summer,Ukraine,6,5,9,20
2012,Summer,Canada,1,5,12,18
2012,Summer,Hungary,8,4,6,18
2012,Summer,Brazil,3,5,9,17
2012,Summer,Spain,3,10,4,17
2012,Summer,Cuba,5,3,6,14
2012,Summer,Kazakhstan,7,1,5,13
2012,Summer,New Zealand,6,2,5,13
2012,Summer,Belarus,2,5,5,12
2012,Summer,Iran,4,5,3,12
2012,Summer,Jamaica,4,4,4,12
2012,Summer,Kenya,2,4,5,11
2012,Summer,Azerbaijan,2,2,6,10
2012,Summer,Czech Republic,4,3,3,10
2012,Summer,Poland,2,2,6,10
2012,Summer,Denmark,2,4,3,9
2012,Summer,Romania,2,5,2,9
2012,Summer,Colombia,1,3,4,8
2012,Summer,Sweden,1,4,3,8
2012,Summer,Ethiopia,3,1,3,7
2012,Summer,Georgia,1,3,3,7
2012,Summer,Mexico,1,3,3,7
2012,Summer,Croatia,3,1,2,6
2012,Summer,India,0,2,4,6
2012,Summer,North Korea,4,0,2,6
2012,Summer,South Africa,3,2,1,6
2012,Summer,Ireland,1,1,3,5
2012,Summer,Lithuania,2,1,2,5
2012,Summer,Mongolia,0,2,3,5
2012,Summer,Turkey,2,2,1,5
2012,Summer,Argentina,1,1,2,4
2012,Summer,Norway,2,1,1,4
2012,Summer,Serbia,1,1,2,4
2012,Summer,Slovakia,0,1,3,4
2012,Summer,Slovenia,1,1,2,4
2012,Summer,Switzerland,2,2,0,4
2012,Summer,Trinidad,1,1,2,4
2012,Summer,Armenia,0,1,2,3
2012,Summer,Belgium,0,1,2,3
2012,Summer,Finland,0,1,2,3
2012,Summer,Thailand,0,2,1,3
2012,Summer,Tunisia,1,1,1,3
2012,Summer,Uzbekistan,1,0,2,3
2012,Summer,Bulgaria,0,1,1,2
2012,Summer,Dominican Republic,1,1,0,2
2012,Summer,Egypt,0,2,0,2
2012,Summer,Estonia,0,1,1,2
2012,Summer,Greece,0,0,2,2
2012,Summer,Indonesia,0,1,1,2
2012,Summer,Latvia,1,0,1,2
2012,Summer,Malaysia,0,1,1,2
2012,Summer,Moldova,0,0,2,2
2012,Summer,Puerto Rico,0,1,1,2
2012,Summer,Qatar,0,0,2,2
2012,Summer,Singapore,0,0,2,2
2012,Summer,Taiwan,0,1,1,2
2012,Summer,Afghanistan,0,0,1,1
2012,Summer,Algeria,1,0,0,1
2012,Summer,Bahamas,1,0,0,1
2012,Summer,Bahrain,0,0,1,1
2012,Summer,Botswana,0,1,0,1
2012,Summer,Cyprus,0,1,0,1
2012,Summer,Gabon,0,1,0,1
2012,Summer,Grenada,1,0,0,1
2012,Summer,Guatemala,0,1,0,1
2012,Summer,Kuwait,0,0,1,1
2012,Summer,Montenegro,0,1,0,1
2012,Summer,Morocco,0,0,1,1
2012,Summer,Portugal,0,1,0,1
2012,Summer,Saudi Arabia,0,0,1,1
2012,Summer,Tajikistan,0,0,1,1
2012,Summer,Uganda,1,0,0,1
2012,Summer,Venezuela,1,0,0,1
2014,Winter,Russia,13,11,9,33
2014,Winter,USA,9,7,12,28
2014,Winter,Norway,11,5,10,26
2014,Winter,Canada,10,10,5,25
2014,Winter,Netherlands,8,7,9,24
2014,Winter,Germany,8,6,5,19
2014,Winter,Austria,4,8,5,17
2014,Winter,France,4,4,7,15
2014,Winter,Sweden,2,7,6,15
2014,Winter,Switzerland,6,3,2,11
2014,Winter,China,3,4,2,9
2014,Winter,Czech Republic,2,4,2,8
2014,Winter,Italy,0,2,6,8
2014,Winter,Japan,1,4,3,8
2014,Winter,Slovenia,2,2,4,8
2014,Winter,South Korea,3,3,2,8
2014,Winter,Belarus,5,0,1,6
2014,Winter,Poland,4,1,1,6
2014,Winter,Finland,1,3,1,5
2014,Winter,Latvia,0,2,2,4
2014,Winter,UK,1,1,2,4
2014,Winter,Australia,0,2,1,3
2014,Winter,Ukraine,1,0,1,2
2014,Winter,Croatia,0,1,0,1
2014,Winter,Kazakhstan,0,0,1,1
2014,Winter,Slovakia,1,0,0,1
2016,Summer,USA,46,37,38,121
2016,Summer,China,26,18,26,70
2016,Summer,UK,27,23,17,67
2016,Summer,Russia,19,17,20,56
2016,Summer,France,10,18,14,42
2016,Summer,Germany,17,10,15,42
2016,Summer,Japan,12,8,21,41
2016,Summer,Australia,8,11,10,29
2016,Summer,Italy,8,12,8,28
2016,Summer,Canada,4,3,15,22
2016,Summer,South Korea,9,3,9,21
2016,Summer,Brazil,7,6,6,19
2016,Summer,Netherlands,8,7,4,19
2016,Summer,Azerbaijan,1,7,10,18
2016,Summer,Kazakhstan,3,5,10,18
2016,Summer,New Zealand,4,9,5,18
2016,Summer,Spain,7,4,6,17
2016,Summer,Denmark,2,6,7,15
2016,Summer,Hungary,8,3,4,15
2016,Summer,Kenya,6,6,1,13
2016,Summer,Uzbekistan,4,2,7,13
2016,Summer,Cuba,5,2,4,11
2016,Summer,Jamaica,6,3,2,11
2016,Summer,Poland,2,3,6,11
2016,Summer,Sweden,2,6,3,11
2016,Summer,Ukraine,2,5,4,11
2016,Summer,Croatia,5,3,2,10
2016,Summer,Czech Republic,1,2,7,10
2016,Summer,South Africa,2,6,2,10
2016,Summer,Belarus,1,4,4,9
2016,Summer,Colombia,3,2,3,8
2016,Summer,Ethiopia,1,2,5,8
2016,Summer,Iran,3,1,4,8
2016,Summer,Serbia,2,4,2,8
2016,Summer,Turkey,1,3,4,8
2016,Summer,Georgia,2,1,4,7
2016,Summer,North Korea,2,3,2,7
2016,Summer,Switzerland,3,2,2,7
2016,Summer,Belgium,2,2,2,6
2016,Summer,Greece,3,1,2,6
2016,Summer,Thailand,2,2,2,6
2016,Summer,Malaysia,0,4,1,5
2016,Summer,Mexico,0,3,2,5
2016,Summer,Argentina,3,1,0,4
2016,Summer,Armenia,1,3,0,4
2016,Summer,Lithuania,0,1,3,4
2016,Summer,Norway,0,0,4,4
2016,Summer,Romania,1,1,2,4
2016,Summer,Slovakia,2,2,0,4
2016,Summer,Slovenia,1,2,1,4
2016,Summer,Bulgaria,0,1,2,3
2016,Summer,Egypt,0,0,3,3
2016,Summer,Indonesia,1,2,0,3
2016,Summer,Taiwan,1,0,2,3
2016,Summer,Tunisia,0,0,3,3
2016,Summer,Venezuela,0,1,2,3
2016,Summer,Algeria,0,2,0,2
2016,Summer,Bahamas,1,0,1,2
2016,Summer,Bahrain,1,1,0,2
2016,Summer,India,0,1,1,2
2016,Summer,Individual Olympic Athletes,1,0,1,2
2016,Summer,Ireland,0,2,0,2
2016,Summer,Israel,0,0,2,2
2016,Summer,Ivory Coast,1,0,1,2
2016,Summer,Mongolia,0,1,1,2
2016,Summer,Vietnam,1,1,0,2
2016,Summer,Austria,0,0,1,1
2016,Summer,Burundi,0,1,0,1
2016,Summer,Dominican Republic,0,0,1,1
2016,Summer,Estonia,0,0,1,1
2016,Summer,Fiji,1,0,0,1
2016,Summer,Finland,0,0,1,1
2016,Summer,Grenada,0,1,0,1
2016,Summer,Jordan,1,0,0,1
2016,Summer,Kosovo,1,0,0,1
2016,Summer,Morocco,0,0,1,1
2016,Summer,Niger,0,1,0,1
2016,Summer,Nigeria,0,0,1,1
2016,Summer,Philippines,0,1,0,1
2016,Summer,Portugal,0,0,1,1
2016,Summer,Puerto Rico,1,0,0,1
2016,Summer,Qatar,0,1,0,1
2016,Summer,Singapore,1,0,0,1
2016,Summer,Tajikistan,1,0,0,1
2016,Summer,Trinidad,0,0,1,1
2016,Summer,United Arab Emirates,0,0,1,1
